[
  {
    "type": "mapgen",
    "om_terrain": "afs_modular_greenhouse",
    "object": { "fill_ter": "t_metal_floor_no_roof", "place_nested": [ { "chunks": [ "afs_modular_greenhouse" ], "x": 0, "y": 0 } ] }
  },
  {
    "type": "mapgen",
    "nested_mapgen_id": "afs_modular_greenhouse",
    "object": {
      "mapgensize": [ 24, 24 ],
      "rows": [
        "________________________",
        ",,_______,____,,,,,____,",
        ",,,,,_,,,__,,,,,,___,,,,",
        ",,||||||,,___,,,||||||,,",
        ",,|~ bl|,,____,,|5  5|,,",
        ",,||+|||||633||||=]==|,,",
        ",,|           !     ❺|,,",
        ",,|0000|!||!!|| ❷❷  ❹|,,",
        ",,||||||<|    | ❷❷||||,,",
        ",,1= |||||2222||||| =1,,",
        ",,1=..$..........$..=1,,",
        ",,1=..$..........$..=1,,",
        ",,1=..$..........$..=1,,",
        ",,1=..$..........$..=1,,",
        ",,1=..$..........$..=1,,",
        ",,1=..$..........$..=1,,",
        ",---..$..........$..---,",
        ",,1=..$..........$..=1,,",
        ",,1=..$..........$..=1,,",
        ",,1=..$..........$..=1,,",
        ",,1=..$..........$..=1,,",
        ",,1=..$..........$..=1,,",
        ",,1=..$..........$..=1,,",
        ",,1=..$..........$..=1,,"
      ],
      "flags": [ "ERASE_ALL_BEFORE_PLACING_TERRAIN" ],
      "palettes": [ "afs_habitat_structure", "afs_habitat_residential_furnishing", "afs_habitat_life_support" ],
      "terrain": {
        ".": "t_open_air",
        " ": "t_metal_floor_no_roof",
        ",": "t_region_groundcover_urban",
        "=": "t_wall_clearcrete_alarm",
        "_": [ [ "t_pavement", 4 ], [ "t_region_groundcover_urban", 1 ] ],
        "1": "t_iceslope_up",
        "2": "t_concrete_ramp_down_low",
        "3": "t_door_metal_locked",
        "<": "t_ladder_up",
        "6": "t_afs_industrial_card_reader"
      },
      "furniture": { "0": "f_metal_table", "5": "f_ancient_processor" },
      "items": { "4": { "item": "afs_tools_biolab", "chance": 76 }, "l": { "item": "afs_civilian_hazard_outfit", "chance": 45 } },
      "monsters": { "6": { "monster": "GROUP_ROBOT_FARM_HOSTILE", "chance": 15, "density": 0.1 } },
      "place_nested": [ { "chunks": [ "afs_modular_greenhouse_roof" ], "x": 0, "y": 0, "z": 1 } ]
    }
  },
  {
    "type": "mapgen",
    "nested_mapgen_id": "afs_modular_greenhouse_roof",
    "object": {
      "mapgensize": [ 24, 24 ],
      "rows": [
        "........................",
        "........................",
        "........................",
        "..[[[[[[........      ..",
        "..[    [........   3  ..",
        "..[ 2  [[[[[[[[[[     ..",
        "..[             [  3  ..",
        "..[    |!|    2 [     ..",
        ".1[[[[[|>|      [     1.",
        ".11__  |||[  [[[[  __11.",
        ".11_______[  [_______11.",
        ".11_______[  [_______11.",
        ".11_______[  [_______11.",
        ".11_______[  [_______11.",
        ".11_______[  [_______11.",
        ".11_______[  [_______11.",
        ".         [  [         .",
        ".11_______[  [_______11.",
        ".11_______[  [_______11.",
        ".11_______[  [_______11.",
        ".11_______[  [_______11.",
        ".11_______[  [_______11.",
        ".11_______[  [_______11.",
        ".11_______[  [_______11."
      ],
      "flags": [ "ERASE_ALL_BEFORE_PLACING_TERRAIN" ],
      "palettes": [ "afs_habitat_structure", "afs_habitat_residential_furnishing" ],
      "terrain": {
        ".": "t_open_air",
        "_": "t_clearcrete_roof",
        " ": "t_metal_floor_no_roof",
        "1": "t_iceslope_down",
        "2": "t_metal_floor_no_roof",
        "3": "t_metal_floor_no_roof",
        "4": "t_metal_floor_no_roof",
        ">": "t_ladder_down"
      },
      "furniture": { "2": "f_small_satellite_dish", "3": "f_drone_recharge_station" },
      "place_nested": [ { "chunks": [ "afs_modular_greenhouse_roof_above" ], "x": 0, "y": 0, "z": 1 } ]
    }
  },
  {
    "type": "mapgen",
    "nested_mapgen_id": "afs_modular_greenhouse_roof_above",
    "object": {
      "mapgensize": [ 24, 24 ],
      "rows": [
        "                        ",
        "                        ",
        "                        ",
        "                        ",
        "                        ",
        "                        ",
        "                        ",
        "       ...              ",
        "       ...              ",
        "       ...              ",
        "                        ",
        "                        ",
        "                        ",
        "                        ",
        "                        ",
        "                        ",
        "                        ",
        "                        ",
        "                        ",
        "                        ",
        "                        ",
        "                        ",
        "                        ",
        "                        "
      ],
      "flags": [ "ERASE_ALL_BEFORE_PLACING_TERRAIN" ],
      "terrain": { " ": "t_open_air", ".": "t_metal_floor_no_roof" }
    }
  },
  {
    "type": "mapgen",
    "om_terrain": "afs_modular_greenhouse_moxie",
    "object": {
      "fill_ter": "t_metal_floor_no_roof",
      "rows": [
        "########################",
        "########################",
        "########################",
        "########################",
        "########################",
        "########################",
        "########################",
        "########################",
        "#########||||||#########",
        "###|||||||2222|||||||###",
        "###|   5        5   |###",
        "###| 515 5    5 5 5 |###",
        "###|15 5111   5 5 5 |###",
        "###| 5 5 11 1 5 5 51|###",
        "###| 31115  115 5 51|###",
        "###| 111 5    515114|###",
        "###|11 5 5  11515334|###",
        "###| 515 5 11 111341|###",
        "###|15 511  11115131|###",
        "###|1515  111 515  1|###",
        "###| 51115 1  115 11|###",
        "###| 513 11   51111 |###",
        "###|1515 111 15 3111|###",
        "###|111515 1 11151 1|###"
      ],
      "flags": [ "ERASE_ALL_BEFORE_PLACING_TERRAIN" ],
      "palettes": [ "afs_habitat_structure", "afs_habitat_residential_furnishing" ],
      "terrain": {
        " ": "t_metal_floor",
        "#": "t_ice_wall",
        "1": "t_moxfloor",
        "2": "t_concrete_ramp_up_high",
        "3": "t_moxfloor",
        "4": "t_moxfloor",
        "5": "t_moxfloor"
      },
      "furniture": { "3": "f_moxie_tube", "4": "f_geo_mox", "5": "f_algae_bioreactor" },
      "items": { "1": { "item": "afs_dead_survivor", "chance": 1 }, "9": { "item": "afs_civilian_hazard_outfit", "chance": 76 } },
      "monsters": { "1": { "monster": "AFS_GROUP_MOXIE_MEDIUM_RISK", "chance": 20, "density": 0.05 } }
    }
  },
  {
    "type": "mapgen",
    "om_terrain": "afs_modular_greenhouse_algae",
    "object": {
      "fill_ter": "t_metal_floor_no_roof",
      "rows": [
        "########################",
        "########################",
        "########################",
        "########################",
        "########################",
        "########################",
        "########################",
        "########################",
        "#########||||||#########",
        "###|||||||2222|||||||###",
        "###|   1        1   |###",
        "###| 1 1 1    1 1 1 |###",
        "###| 1 1 1    1 1 1 |###",
        "###| 1 1 1 ,, 1 1 1 |###",
        "###| 1 1 1    1 1 1 |###",
        "###| 1 1 1    1 1 1 |###",
        "###| 1 1 1    1 1 1 |###",
        "###| 1 1 1    1 1 1 |###",
        "###| 1   1    1   1 |###",
        "###| 1 1 1    1 1 1 |###",
        "###| 1 1 1 ,, 1 1 1 |###",
        "##|| 1 1 1    1 1 1 |###",
        "##|3 1 1 1    1 1 1 |###",
        "##|| 1 1 1    1 1 1 |###"
      ],
      "flags": [ "ERASE_ALL_BEFORE_PLACING_TERRAIN" ],
      "palettes": [ "afs_habitat_structure", "afs_habitat_residential_furnishing" ],
      "terrain": { " ": "t_metal_floor", "#": "t_ice_wall", "2": "t_concrete_ramp_up_high" },
      "furniture": { "1": "f_algae_bioreactor", "3": "f_future_industy_pump" },
      "monsters": { " ": { "monster": "GROUP_ROBOT_FARM_HOSTILE", "chance": 120, "density": 0.1 } }
    }
  },
  {
    "type": "mapgen",
    "om_terrain": "afs_modular_greenhouse_slurry",
    "object": {
      "fill_ter": "t_metal_floor_no_roof",
      "rows": [
        "########################",
        "########################",
        "########################",
        "########################",
        "########################",
        "########################",
        "########################",
        "########################",
        "#########||||||#########",
        "###|||||||2222|||||||###",
        "###|11111[    [11111|###",
        "###|11111[    [11111|###",
        "###|11111[    [11111|###",
        "###|11111[ ,, [11111|###",
        "###|$$$$$$    $$$$$$|###",
        "###|11111[    [11111|###",
        "###|11111[    [11111|###",
        "###|11111[    [11111|###",
        "###|11111[    [11111|###",
        "###|11111[    [11111|###",
        "###|$$$$$$ ,, $$$$$$|###",
        "###|11111[    [11111|###",
        "###|11111[    [11111|###",
        "###|11111[    [11111|###"
      ],
      "flags": [ "ERASE_ALL_BEFORE_PLACING_TERRAIN" ],
      "palettes": [ "afs_habitat_structure", "afs_habitat_residential_furnishing" ],
      "terrain": { " ": "t_metal_floor", "#": "t_ice_wall", "1": "t_toxic_water", "2": "t_concrete_ramp_up_high" },
      "item": { "1": { "item": "afs_biomaterial_1", "chance": 33, "repeat": [ 1, 3 ] } }
    }
  },
  {
    "type": "mapgen",
    "om_terrain": "afs_modular_greenhouse_hydro",
    "object": {
      "fill_ter": "t_metal_floor_no_roof",
      "rows": [
        "########################",
        "########################",
        "########################",
        "########################",
        "########################",
        "########################",
        "########################",
        "########################",
        "#########||||||#########",
        "###|||||||2222|||||||###",
        "###|                |###",
        "###| 11111    11111 |###",
        "###| 11113    11111 |###",
        "###| 11111 ,, 31111 |###",
        "###| 11111    11111 |###",
        "###| 11111    11111 |###",
        "###|                |###",
        "###| 11111    11111 |###",
        "###| 11111    11111 |###",
        "###| 11311    31111 |###",
        "###| 11111 ,, 11111 |###",
        "###|   400    200   |###",
        "###|                |###",
        "###|                |###"
      ],
      "flags": [ "ERASE_ALL_BEFORE_PLACING_TERRAIN" ],
      "palettes": [ "afs_habitat_structure", "afs_habitat_residential_furnishing" ],
      "terrain": { " ": "t_metal_floor", "#": "t_ice_wall", "1": "t_water_sh", "2": "t_concrete_ramp_up_high", "3": "t_water_sh" },
      "furniture": { "0": "f_metal_table", "3": "f_future_industy_pump" },
      "items": { "0": { "item": "afs_tools_biolab", "chance": 76 } },
      "computers": {
        "4": {
          "name": "ColNet access point",
          "eocs": [ "EOC_GENERIC_SALVAGE_COMPUTER" ],
          "chat_topics": [ "COMPUTER_GENERIC_SALVAGE_LOCKED" ]
        }
      }
    }
  }
]
