[
  {
    "type": "mapgen",
    "om_terrain": [ "default_portal_storm_dungeon_overmap" ],
    "object": {
      "rows": [
        "---Q---Q---oo---Q----Q--",
        "-        -    -   Q     ",
        "Q        Q    Q     q q ",
        "---Q---  -    -  ---- - ",
        "Q   -    -    -     Q - ",
        "-   -         ------- --",
        "-                       ",
        "-   -----Q---Q------    ",
        "-          -            ",
        "-          O            ",
        "-----o---Q---Q----o-----",
        "o                       ",
        "o                       ",
        "---Q--o-  -o----o---o---",
        "Q   Q  -  -  Q    -     ",
        "-      -  -  -    -     ",
        "------o-  -o----o---o---",
        "-         -       -     ",
        "Q         -       -     ",
        "--------  ----- ----o---",
        "Q         -       -     ",
        "-   -----Q-       -     ",
        "-   Q  q  -----   -     ",
        "Q                 -     "
      ],
      "palettes": [ "portal_storm_dungeon_palette" ]
    }
  },
  {
    "type": "mapgen",
    "om_terrain": [ "default_portal_storm_dungeon_overmap" ],
    "object": {
      "rows": [
        "------Q----oo----Q--Q---",
        "-  -                    ",
        "Q  Q                    ",
        "-  -    -----Q----      ",
        "- q--            -----oo",
        "-   -                -  ",
        "-Q  ---O-----o----   -  ",
        "-   O    -           O  ",
        "Q   -    -           -  ",
        "-- --    q      -    -  ",
        "-   -    -      -    -  ",
        "o   -  -----    --Q---  ",
        "o   Q    -      -    -  ",
        "-   -    -      -    -  ",
        "-- --  -----         q  ",
        "-   -    q      -    -  ",
        "Q   Q    -      -    -  ",
        "-   -  -----    --Q---  ",
        "Q   -    -      -    -  ",
        "-   -    -      -    O  ",
        "-   O  -----         -  ",
        "Q   -    -      -    -  ",
        "-   -    Q      --Q---  ",
        "-   -    -      -       "
      ],
      "palettes": [ "portal_storm_dungeon_palette" ]
    }
  },
  {
    "type": "mapgen",
    "om_terrain": [ "default_portal_storm_dungeon_overmap" ],
    "object": {
      "rows": [
        "--Q----Q---oo-------Q---",
        "-                       ",
        "Q                       ",
        "----O---------Q---- ----",
        "-       q        q  O   ",
        "-       -        -  --- ",
        "--O---O--   ------  Q   ",
        "-                   - --",
        "Q                   Q   ",
        "-  -------Q-------  -   ",
        "-  -             -  -   ",
        "o  -             -  -   ",
        "o  -  ----Q----  -  -   ",
        "-  Q  Q     @ Q  -  -   ",
        "-  -  -  Q    -  -  Q   ",
        "-  -  -  ------  -  -   ",
        "Q  -  -          -  -   ",
        "-  -  -          -  -   ",
        "-  -  ---Q----Q---  -   ",
        "-  -                -   ",
        "Q  Q                Q   ",
        "-  ----Q-----------Q-   ",
        "-                       ",
        "-                       "
      ],
      "palettes": [ "portal_storm_dungeon_palette" ],
      "items": { "@": { "item": "portal_storm_dungeon_items", "chance": 15 } }
    }
  },
  {
    "type": "mapgen",
    "om_terrain": [ "default_portal_storm_dungeon_overmap" ],
    "object": {
      "rows": [
        "----Q---Q--oo----Q-----Q",
        "-         -  -          ",
        "Q     Q   -  -          ",
        "-     -   -  -------Q-  ",
        "-- --------  -       -  ",
        "-         o  o       -  ",
        "Q         -  ------  -  ",
        "--------- -  -       -  ",
        "-     -   -  -   Q      ",
        "Q     -   -  -   -   Q  ",
        "-----o-----  -----o-----",
        "o                       ",
        "o                       ",
        "-----o-----  -----o-----",
        "Q   -     -  Q   -   -  ",
        "-   O     -  - ---      ",
        "-  ----- --  -   -----  ",
        "-   -     -  ---     -  ",
        "Q   Q     o  o       -Q-",
        "-   -- ----  -       -  ",
        "--- -     -  --Q--- --  ",
        "-   ----- -  -   -   - -",
        "Q  --     Q  -   -   o  ",
        "-         -  Q       -  "
      ],
      "palettes": [ "portal_storm_dungeon_palette" ]
    }
  },
  {
    "type": "mapgen",
    "om_terrain": [ "default_portal_storm_dungeon_overmap" ],
    "object": {
      "rows": [
        "-q----Q----oo---Q-----q-",
        "-  -    -      o  Q     ",
        "-  -    -      -     Q  ",
        "-  ---  -      ----q----",
        "Q    Q  O      o        ",
        "-  ---  -      -        ",
        "-    -  -      ---o--o--",
        "Q    Q  O      O        ",
        "---O-----      -----Q---",
        "-                       ",
        "-                       ",
        "o                       ",
        "o                       ",
        "-                       ",
        "-                       ",
        "---o-----      -----O---",
        "Q       Q      Q        ",
        "-       -      -        ",
        "Q       O      O        ",
        "---q-----      -----q---",
        "-       -      -        ",
        "Q       O      O        ",
        "-       -      -        ",
        "-       -      -        "
      ],
      "palettes": [ "portal_storm_dungeon_palette" ]
    }
  },
  {
    "type": "mapgen",
    "om_terrain": [ "default_portal_storm_dungeon_overmap" ],
    "object": {
      "rows": [
        "---Q---Q--oo----Q--Q---Q",
        "-     -        -     -  ",
        "Q     -        -     -  ",
        "-  ----  ----  -  -  -  ",
        "-  -     -  -     -  -  ",
        "-  -     -  -     -  -  ",
        "Q  -  -qq-  ----qq-  -  ",
        "-  -  -        -        ",
        "-  -  -        -        ",
        "-  -  -  ----  -  ------",
        "o     -  -     -  -     ",
        "o     -  -     -  -     ",
        "----------  -  -  -  -  ",
        "-           -  -     -  ",
        "Q           -  -     -  ",
        "-  -qq----qq-  -------qq",
        "Q  -  -  -  -           ",
        "-  -  -  -  -           ",
        "-  -  -  -  -  ---------",
        "Q     -           q     ",
        "-     -           q     ",
        "----  ----------  -  -  ",
        "Q           q        -  ",
        "-           q        -  "
      ],
      "palettes": [ "portal_storm_dungeon_palette" ]
    }
  },
  {
    "type": "mapgen",
    "om_terrain": [ "default_portal_storm_dungeon_overmap" ],
    "weight": 750,
    "object": {
      "rows": [
        "--Q----Q---oo-------Q---",
        "-                       ",
        "Q                       ",
        "----O---------  --- ----",
        "-       q        q  O   ",
        "-       -        -  --- ",
        "--O--O---   ------  Q   ",
        "-   - -          -  - --",
        "Q   O -   ~~~~   -  Q   ",
        "-  -- -  ~~~~~~  -  -   ",
        "-  -  - ~~~~~~~~ -  -   ",
        "o  -  - ~~~~~~~~ -  -   ",
        "o  -  - ~~~~~~~~ -  -   ",
        "-  Q  - ~~~~~~~~ -  -   ",
        "-  ----  ~~~~~~  -  Q   ",
        "-  -  -   ~~~~   -  -   ",
        "Q  -  -          -  -   ",
        "-  -  ---Q----Q---  --Q-",
        "-  -                -   ",
        "-  -                -   ",
        "Q  ----Q-----------Q-   ",
        "-                   -   ",
        "-----Q-----------Q---   ",
        "-                       "
      ],
      "palettes": [ "portal_storm_dungeon_palette" ]
    }
  },
  {
    "type": "mapgen",
    "om_terrain": [ "default_portal_storm_dungeon_overmap" ],
    "weight": 650,
    "object": {
      "rows": [
        "--Q----Q---oo-------Q---",
        "-                       ",
        "Q                       ",
        "-  ---------------------",
        "-  ---------------------",
        "-  ---------------------",
        "-  ---------------------",
        "-  ---------------------",
        "Q  ---------------------",
        "-  ---------------------",
        "-  ---------------------",
        "o  ---------------------",
        "o  ---------------------",
        "-  ---------------------",
        "-  ---------------------",
        "-  ---------------------",
        "Q  ---------------------",
        "-  ---------------------",
        "-  ---------------------",
        "-  ---------------------",
        "Q  ---------- ----------",
        "-  ---------- ----------",
        "-  ----------o----------",
        "-                       "
      ],
      "palettes": [ "portal_storm_dungeon_palette" ],
      "place_nested": [ { "chunks": [ [ "null", 1 ], [ "portal_dungeon_15x15_vault", 4 ] ], "x": 6, "y": 5 } ]
    }
  },
  {
    "type": "mapgen",
    "om_terrain": [ "default_portal_storm_dungeon_overmap" ],
    "weight": 450,
    "object": {
      "rows": [
        "-----------oo-----------",
        "-~~~~~~~~~_  _~~~~~~~~~~",
        "-~~~~~~~~~_  _~~~~~~~~~~",
        "-~~~~~~~~~_  _~~~~~~~~~~",
        "-~~~~~~~~~_  _~~~~~~~~~~",
        "-~~~~~~~~~_  _~~~~~~~~~~",
        "-~~~~~~~~~_  _~~~~~~~~~~",
        "-~~~~~~~~~_  _~~~~~~~~~~",
        "-~~~~~~~~~_  _~~~~~~~~~~",
        "-~~~~~~~~~_  _~~~~~~~~~~",
        "-__________  ___________",
        "o                       ",
        "o                       ",
        "-__________  ___________",
        "-~~~~~~~~~_  _~~~~~~~~~~",
        "-~~~~~~~~~_  _~~~~~~~~~~",
        "-~~~~~~~~~_  _~~~~~~~~~~",
        "-~~~~~~~~~_  _~~~~~~~~~~",
        "-~~~~~~~~~_  _~~~~~~~~~~",
        "-~~~~~~~~~_  _~~~~~~~~~~",
        "-~~~~~~~~~_  _~~~~~~~~~~",
        "-~~~~~~~~~_  _~~~~~~~~~~",
        "-~~~~~~~~~_  _~~~~~~~~~~",
        "-~~~~~~~~~_  _~~~~~~~~~~"
      ],
      "palettes": [ "portal_storm_dungeon_palette" ]
    }
  },
  {
    "type": "mapgen",
    "om_terrain": [ "default_portal_storm_dungeon_overmap" ],
    "weight": 250,
    "object": {
      "rows": [
        "---Q---Q--oo----Q--Q---Q",
        "-~~~~~~~~~~~~~~~~~~~~~~~",
        "Q~~~~~~~~~~~~~~~~~~~~~~~",
        "-~~~~~~~~~~~~~~~~~~~~~~~",
        "-~~~~~~~~~~~~~~~~~~~~~~~",
        "-~~~~~~~~~~~~~~~~~~~~~~~",
        "Q~~~~~~~~~~~~~~~~~~~~~~~",
        "-~~~~~~~~~~~~~~~~~~~~~~~",
        "-~~~~~~~~~~~~~~~~~~~~~~~",
        "-~~~~~~~~~~~~~~~~~~~~~~~",
        "o~~~~~~~~~~~~~~~~~~~~~~~",
        "o~~~~~~~~~~~~~~~~~~~~~~~",
        "-~~~~~~~~~~~~~~~~~~~~~~~",
        "-~~~~~~~~~~~~~~~~~~~~~~~",
        "Q~~~~~~~~~~~~~~~~~~~~~~~",
        "-~~~~~~~~~~~~~~~~~~~~~~~",
        "Q~~~~~~~~~~~~~~~~~~~~~~~",
        "-~~~~~~~~~~~~~~~~~~~~~~~",
        "-~~~~~~~~~~~~~~~~~~~~~~~",
        "Q~~~~~~~~~~~~~~~~~~~~~~~",
        "-~~~~~~~~~~~~~~~~~~~~~~~",
        "-~~~~~~~~~~~~~~~~~~~~~~~",
        "Q~~~~~~~~~~~~~~~~~~~~~~~",
        "-~~~~~~~~~~~~~~~~~~~~~~~"
      ],
      "palettes": [ "portal_storm_dungeon_palette" ]
    }
  }
]
