[
  {
    "type": "mapgen",
    "//": "This is a special based on the mx_mass_grave_dino so Red spawns are unique",
    "om_terrain": "mass_grave_red",
    "weight": 250,
    "object": {
      "fill_ter": "t_region_groundcover",
      "rows": [
        "                        ",
        "   ##  ##  ##  ##  ##   ",
        "   ##  ##  ##  ##  ##   ",
        "   ##  ##  ##  ##  ##   ",
        "   ##  ##  ##  ##  ##   ",
        "   ##  ##  ##  ##  ##  X",
        "   ##  ##  ##  ##  ##   ",
        "   ##  ##  ##  ##  ## X ",
        "   ##  ##  ##  ##  ##   ",
        "   ##  ##  ##  ##  ##   ",
        "   ##  ##  ##  ##  ##  X",
        "   ##  ##  ##  ##  ##   ",
        "   ##  ##  ##  ##  ##   ",
        "   ##  ##  ##  ##  ##   ",
        "   ##  ##  ##  ##  ## X ",
        "   ##  ##  ##  ##  ##   ",
        "   ##  ##  ##  ##  ##   ",
        "   ##  ##  ##  ##  ##   ",
        "   ##  ##  ##  ##  ##   ",
        "   ##  ##  ##  ##  ##   ",
        "   ##  ##  ##  ##  ##  X",
        "   ##  ##  ##  ##  ##   ",
        "   ##  ##  ##  ##  ##   ",
        "                        "
      ],
      "terrain": { "#": [ [ "t_dirt", 24 ], [ "t_pit_shallow", 1 ] ] },
      "furniture": { "X": [ [ "f_null", 19 ], [ "f_battlefield_cross", 1 ] ] },
      "place_loot": [
        { "group": "mass_grave_casings", "repeat": [ 20, 30 ], "x": [ 1, 23 ], "y": [ 1, 17 ] },
        { "group": "mass_grave_casings", "repeat": [ 10, 15 ], "x": [ 1, 23 ], "y": [ 18, 23 ] },
        { "group": "SUS_trash_floor", "repeat": [ 1, 3 ], "x": [ 1, 23 ], "y": [ 18, 23 ] }
      ],
      "place_monsters": [ { "monster": "GROUP_DINOSAUR_ZOMBIE_SCORCHED", "density": 0.1, "x": [ 1, 22 ], "y": [ 1, 22 ] } ],
      "monster": { "#": { "monster": "mon_zaspletosaurus_scorched", "chance": 1 } },
      "flags": [ "ERASE_ALL_BEFORE_PLACING_TERRAIN" ],
      "place_nested": [
        { "chunks": [ "NC_Red_spawn" ], "x": [ 3 ], "y": [ 1 ] },
        { "chunks": [ "old_guard_red_soldier_spawn" ], "x": [ 1 ], "y": [ 1 ] },
        { "chunks": [ "old_guard_red_soldier_spawn" ], "x": [ 5 ], "y": [ 1 ] },
        { "chunks": [ "old_guard_red_soldier_spawn" ], "x": [ 1 ], "y": [ 6 ] },
        { "chunks": [ "old_guard_red_soldier_spawn" ], "x": [ 5 ], "y": [ 6 ] }
      ]
    }
  }
]
